111111111111
1000101000N1
100010000001
100000100001
100010100001
111111111111