 1111111111111111
1000100001010101
 100000100001001
100010000010001
 10000100000001
100101 10001001
 10100100001001
1000100N00000001
 1000100010001001
1010101000010001
 100010000100111
  11111111111