NO texture/commodore.xpm

SO texture/eagle_1.xpm

WE texture/mossy_1.xpm

EA texture/wood.xpm

F 0, 255, 0

C 225, 93, 255

111111111111111111111111111111111111
100000000000000000000000000000000001
100S00011000011000000000000110000001
100000011000011000000000000110000001
100000000000000000000000000000000001
100110000001000001100001100000011001
100110000001000001100001100000011001
100000000000000000000000000000000001
100000000000000000000000000000000001
100110000001000001100001100000011001
100110000001000001100001100000011001
100000000000000000000000000000000001
100000011000011000000000000110000001
111111111111111111111111111111111111
