111111111111
100010100001
1000001N0001
100010100001
100010100001
100010100001
100010100001
100010100001
100010100001
100010100001
111111111111