NO texture/commodore.xpm

SO texture/eagle_1.xpm

WE texture/mossy_1.xpm

EA texture/wood.xpm

F 0, 255, 0

C 225, 93, 255

111111111111111111111111111111111111111111111111111111111111111111111111111111111111111111111111111111111111111
1S0001100000000000000000110000000000000000000000000110000000000000000011000000000000000110000000000000000000001
101011100000000000010001110000000000000000001000001110000000000001000111000000000010001110000000000000000000001
100000000000000000010000000000000000000000001000000000000000000001000000000000000010000000000000000000000000001
101011100000000000010001110000000000000000001000001110000000000001000111000000000010001110000000000000000000001
100001100000111011110000110000011101001110110000000110000011101111000011000111011110000110000011101000011101101
111111111011100000010011111101110000111000001011111111101110000001001111111100000010011111101110000101110000001
111111111011101010010011111101110101111010101111111111101110101001001111111101010010011111101110101101110101001
100110101011100000010011010101110000111000000000011010101110000001001101011100000010011010101110000101110000001
100000000001100000010000000000110000011000000000000000000110000001000000001100000010000000000110000000110000001
100000000001101010010000000000110101011010100000000000000110101001000000001101010010000000000110101000110101001
110110101000000000000011010100000000000000000000011110100000000000001101000000000000011010100000000100000000001
111110101000000000000011010100000000000000001011111 10100000000000001101000000000000011010100000000100000000001
100001100000100000010000110000010000001000000000000110000010000001000011000100000010000110000010000000010000001
100000000000000000000000000000000000000000000000000000000000000000000000000000000000000000000000000000000000001
100000011000000000000110000000000001100000000000011000000000000110000000000000110000000000000110000000110000001
100000011000000000000110000000000001100000000000011000000000000110000000000000110000000000000110000000110000001
100000000000000000000000000000000000000000000000000000000000000000000000000000000000000000000000000000000000001
100110000001100001100000011000011000000110000110000001100001100000011000001100000011000001100000001100000011001
100110000001100001100000011000011000000110000110000001100001100000011000001100000011000001100000001100000011001
100000000000000000000000000000000000000000000000000000000000000000000000000000000000000000000000000000000000001
100000011000000000000110000000000001100000000000011000000000000110000000000000110000000000000110000000110000001
100000011000000000000110000000000001100000000000011000000000000110000000000000110000000000000110000000110000001
100000000000000000000000000000000000000000000000000000000000000000000000000000000000000000000000000000000000001
110110101000000000000011010100000000000000000000011110100000000000001101000000000000011010100000000100000000001
111110101000000000000011010100000000000000001011111 10100000000000001101000000000000011010100000000100000000001
100001100000100000010000110000010000001000000000000110000010000001000011000100000010000110000010000000010000001
100000000000000000000000000000000000000000000000000000000000000000000000000000000000000000000000000000000000001
100000011000000000000110000000000001100000000000011000000000000110000000000000110000000000000110000000110000001
100000011000000000000110000000000001100000000000011000000000000110000000000000110000000000000110000000110000001
100000000000000000000000000000000000000000000000000000000000000000000000000000000000000000000000000000000000001
100000000001010000101000000000101000010100000000000000000101000010100000001010000101000000000101000000101000001
100001000010001010001000100001000101100010100000000100001000101000100010010001010001000100001000101001000101001
100001101000000000000000110100000000000000000000000110100000000000000011000000000000000110100000000100000000001
100000100000001010000000010000000101000010100000000010000000101000000001000001010000000010000000101000000101001
101011100000000000010001110000000000000000001000001110000000000001000111000000000010001110000000000000000000001
100000000000000000010000000000000000000000001000000000000000000001000000000000000010000000000000000000000000001
101011100000000000010001110000000000000000001000001110000000000001000111000000000010001110000000000000000000001
100001100000111011110000110000011101001110110000000110000011101111000011000111011110000110000011101000011101101
111111111011100000010011111101110000111000001011111111101110000001001111111100000010011111101110000101110000001
111111111011101010010011111101110101111010101111111111101110101001001111111101010010011111101110101101110101001
100110101011100000010011010101110000111000000000011010101110000001001101011100000010011010101110000101110000001
100000000001100000010000000000110000011000000000000000000110000001000000001100000010000000000110000000110000001
110110101000000000000011010100000000000000000000011110100000000000001101000000000000011010100000000100000000001
111110101000000000000011010100000000000000001011111 10100000000000001101000000000000011010100000000100000000001
100001100000100000010000110000010000001000000000000110000010000001000011000100000010000110000010000000010000001
100000000001101010010000000000110101011010100000000000000110101001000000001101010010000000000110101000110101001
110110101000000000000011010100000000000000000000011010100000000000001101000000000000011010100000000100000000001
111110101000000000000011010100000000000000001011111010100000000000001101000000000000011010100000000100000000001
100001100000100000010000110000010000001000000000000110000010000001000011000100000010000110000010000000010000001
100000000001010000101000000000101000010100000000000000000101000010100000001010000101000000000101000000101000001
100001000010001010001000100001000101100010100000000100001000101000100010010001010001000100001000101001000101001
100001101000000000000000110100000000000000000000000110100000000000000011000000000000000110100000000100000000001
100000100000001010000000010000000101000010100000000010000000101000000001000001010000000010000000101000000101001
110110101000000000000011010100000000000000000000011010100000000000001101000000000000011010100000000100000000001
110110101000000000000011010100000000000000000000011110100000000000001101000000000000011010100000000100000000001
111110101000000000000011010100000000000000001011111 10100000000000001101000000000000011010100000000100000000001
100001100000100000010000110000010000001000000000000110000010000001000011000100000010000110000010000000010000001
111110101000000000000011010100000000000000001011111010100000000000001101000000000000011010100000000100000000001
100001100000100000010000110000010000001000000000000110000010000001000011000100000010000110000010000000010000001
100000000000000000000000000000000000000000000000000000000000000000000000000000000000000000000000000000000000001
100000011000000000000110000000000001100000000000011000000000000110000000000000110000000000000110000000110000001
110110101000000000000011010100000000000000000000011110100000000000001101000000000000011010100000000100000000001
111110101000000000000011010100000000000000001011111 10100000000000001101000000000000011010100000000100000000001
100001100000100000010000110000010000001000000000000110000010000001000011000100000010000110000010000000010000001
100000011000000000000110000000000001100000000000011000000000000110000000000000110000000000000110000000110000001
100000000000000000000000000000000000000000000000000000000000000000000000000000000000000000000000000000000000001
100110000001100001100000011000011000000110000110000001100001100000011000001100000011000001100000001100000011001
100110000001100001100000011000011000000110000110000001100001100000011000001100000011000001100000001100000011001
100000000000000000000000000000000000000000000000000000000000000000000000000000000000000000000000000000000000001
100000011000000000000110000000000001100000000000011000000000000110000000000000110000000000000110000000110000001
100000011000000000000110000000000001100000000000011000000000000110000000000000110000000000000110000000110000001
100000000000000000000000000000000000000000000000000000000000000000000000000000000000000000000000000000000000001
100000000000000000000000000000000000000000000000000000000000000000000000000000000000000000000000000000000000001
100000011000000000000110000000000001100000000000011000000000000110000000000000110000000000000110000000110000001
100000011000000000000110000000000001100000000000011000000000000110000000000000110000000000000110000000110000001
100000000001010000101000000000101000010100000000000000000101000010100000001010000101000000000101000000101000001
100001000010001010001000100001000101100010100000000100001000101000100010010001010001000100001000101001000101001
100001101000000000000000110100000000000000000000000110100000000000000011000000000000000110100000000100000000001
100000100000001010000000010000000101000010100000000010000000101000000001000001010000000010000000101000000101001
110110101000000000000011010100000000000000000000011110100000000000001101000000000000011010100000000100000000001
111110101000000000000011010100000000000000001011111 10100000000000001101000000000000011010100000000100000000001
100001100000100000010000110000010000001000000000000110000010000001000011000100000010000110000010000000010000001
101011100000000000010001110000000000000000001000001110000000000001000111000000000010001110000000000000000000001
100000000000000000010000000000000000000000001000000000000000000001000000000000000010000000000000000000000000001
101011100000000000010001110000000000000000001000001110000000000001000111000000000010001110000000000000000000001
100001100000111011110000110000011101001110110000000110000011101111000011000111011110000110000011101000011101101
111111111011100000010011111101110000111000001011111111101110000001001111111100000010011111101110000101110000001
110110101000000000000011010100000000000000000000011110100000000000001101000000000000011010100000000100000000001
111110101000000000000011010100000000000000001011111 10100000000000001101000000000000011010100000000100000000001
100001100000100000010000110000010000001000000000000110000010000001000011000100000010000110000010000000010000001
111111111011101010010011111101110101111010101111111111101110101001001111111101010010011111101110101101110101001
100110101011100000010011010101110000111000000000011010101110000001001101011100000010011010101110000101110000001
100000000001100000010000000000110000011000000000000000000110000001000000001100000010000000000110000000110000001
100000000001101010010000000000110101011010100000000000000110101001000000001101010010000000000110101000110101001
110110101000000000000011010100000000000000000000011010100000000000001101000000000000011010100000000100000000001
111110101000000000000011010100000000000000001011111010100000000000001101000000000000011010100000000100000000001
100001100000100000010000110000010000001000000000000110000010000001000011000100000010000110000010000000010000001
100000000001010000101000000000101000010100000000000000000101000010100000001010000101000000000101000000101000001
100001000010001010001000100001000101100010100000000100001000101000100010010001010001000100001000101001000101001
100001101000000000000000110100000000000000000000000110100000000000000011000000000000000110100000000100000000001
100000100000001010000000010000000101000010100000000010000000101000000001000001010000000010000000101000000101001
111111111111111111111111111111111111111111111111111111111111111111111111111111111111111111111111111111111111111