 11111111111111111111111111111111111111111111111111111111111111111111111111111111111111
 10000000000000000000000000000000000000000000000000000000000000000000000000000000000001
 100S0001100000000000011000000000000110000000000001100000000000011000000000000110000001
 10000001100000000000011000000000000110000000000001100000000000011000000000000110000001
 10000000000000000000000000000000000000000000000000000000000000000000000000000000000001
 10011000000110000110000001100001100000011000011000000110000110000001100001100000011001
 10011000000110000110000001100001100000011000011000000110000110000001100001100000011001
 10000000000000000000000000000000000000000000000000000000000000000000000000000000000001
 10000001100000000000011000000000000010000000000001100000000000011000000000000110000001
 10000001100000000000011000000000000100000000000001100000000000011000000000000110000001
 10000000000000000000000000000000000000000000000000000000000000000000000000000000000001
 10000000000000000000000000000000000000000000000000000000000000000000000000000000000001
 10000001100000000000011000000000000110000000000001100000000000011000000000000110000001
 10000001100000000000011000000000000110000000000001100000000000011000000000000110000001
 10000000000000000000000000000000000000000000000000000000000000000000000000000000000001
 10011000000110000110000001100001100000011000011000000110000110000001100001100000011001
 10011000000110000110000001100001100000011000011000000110000110000001100001100000011001
 10000000000000000000000000000000000000000000000000000000000000000000000000000000000001
 10000001100000000000011000000000000110000000000001100000000000011000000000000110000001
 10000001100000000000011000000000000110000000000001100000000000011000000000000110000001
 10000000000000000000000000000000000000000000000000000000000000000000000000000000000001
 10000000000000000000000000000000000000000000000000000000000000000000000000000000000001
 10000001100000000000011000000000000110000000000001100000000000011000000000000110000001
 10000001100000000000011000000000000110000000000001100000000000011000000000000110000001
 10000000000000000000000000000000000000000000000000000000000000000000000000000000000001
 10011000000110000110000001100001100000011000011000000110000110000001100001100000011001
 10011000000110000110000001100001100000011000011000000110000110000001100001100000011001
 10000000000000000000000000000000000000000000000000000000000000000000000000000000000001
 10000001100000000000011000000000000110000000000001100000000000011000000000000110000001
 10000001100000000000011000000000000110000000000001100000000000011000000000000110000001
 10000000000000000000000000000000000000000000000000000000000000000000000000000000000001
 10000000000000000000000000000000000000000000000000000000000000000000000000000000000001
 10000001100000000000011000000000000110000000000001100000000000011000000000000110000001
 10000001100000000000011000000000000110000000000001100000000000011000000000000110000001
 10000000000000000000000000000000000000000000000000000000000000000000000000000000000001
 10011000000110000110000001100001100000011000011000000110000110000001100001100000011001
 10011000000110000110000001100001100000011000011000000110000110000001100001100000011001
 10000000000000000000000000000000000000000000000000000000000000000000000000000000000001
 10000001100000000000011000000000000110000000000001100000000000011000000000000110000001
 10000001100000000000011000000000000110000000000001100000000000011000000000000110000001
 10000000000000000000000000000000000000000000000000000000000000000000000000000000000001
 10000000000000000000000000000000000000000000000000000000000000000000000000000000000001
 10000001100000000000011000000000000110000000000001100000000000011000000000000110000001
 10000001100000000000011000000000000110000000000001100000000000011000000000000110000001
 10000000000000000000000000000000000000000000000000000000000000000000000000000000000001
 10011000000110000110000001100001100000011000011000000110000110000001100001100000011001
 10011000000110000110000001100001100000011000011000000110000110000001100001100000011001
 10000000000000000000000000000000000000000000000000000000000000000000000000000000000001
 10000001100000000000011000000000000110000000000001100000000000011000000000000110000001
 10000001100000000000011000000000000110000000000001100000000000011000000000000110000001
 10000000000000000000000000000000000000000000000000000000000000000000000000000000000001
 10000000000000000000000000000000000000000000000000000000000000000000000000000000000001
 10000001100000000000011000000000000110000000000001100000000000011000000000000110000001
 10000001100000000000011000000000000110000000000001100000000000011000000000000110000001
 10000000000000000000000000000000000000000000000000000000000000000000000000000000000001
 10011000000110000110000001100001100000011000011000000110000110000001100001100000011001
 10011000000110000110000001100001100000001000011000000110000110000001100001100000011001
 10000000000000000000000000000000000000000000000000000000000000000000000000000000000001
 10000001100000000000011000000000000110000000000001100000000000011000000000000110000001
 10000001100000000000011000000000000110000000000001100000000000011000000000000110000001
 10000000000000000000000000000000000000000000000000000000000000000000000000000000000001
 10000000000000000000000000000000000000000000000000000000000000000000000000000000000001
 10000001100000000000011000000000000110000000000001100000000000011000000000000110000001
 10000001100000000000011000000000000110000000000001100000000000011000000000000110000001
 10000000000000000000000000000000000000000000000000000000000000000000000000000000000001
 10011000000110000110000001100001100000011000011000000110000110000001100001100000011001
 10011000000110000110000001100001100000011000011000000110000110000001100001100000011001
 10000000000000000000000000000000000000000000000000000000000000000000000000000000000001
 10000001100000000000011000000000000110000000000001100000000000011000000000000110000001
 10000001100000000000011000000000000110000000000001100000000000011000000000000110000001
 10000000000000000000000000000000000000000000000000000000000000000000000000000000000001
 11111111111111111111111111111111111111111111111111111111111111111111111111111111111111